Oracle	SQL
Accesories_DBCIDoorMaster	
Accesories_Partition	Accesories_Partition
Accesories_PartitionGirtSpacing	Accesories_PartitionGirtSpacing
Accesories_PartitionMaster	Accesories_PartitionMaster
Accesories_PartitionModuleSpacing	Accesories_PartitionModuleSpacing
Accesories_Partition_bkp_11_07	
Accesories_Partition_bkp_27_06	
Accesories_PurlinExtensions	Accesories_PurlinExtensions
Accesories_RoofLTP	Accesories_RoofLTP
Accesories_RoofLTP_Common	Accesories_RoofLTP_Common
Accesories_RoofLTP_Length	Accesories_RoofLTP_Length
Accesories_TopMountedSlideDoor	Accesories_TopMountedSlideDoor
Accesories_Wainscot	Accesories_Wainscot
Accesories_WallLTP	Accesories_WallLTP
Accesories_WallLTP_Common	Accesories_WallLTP_Common
Accesories_WallLTP_Size	Accesories_WallLTP_Size
Accesories_Windows	Accesories_Windows
Accesories_Windows_bkp_15_07	
Accesories_Windows_bkp_27_06	
Accessories_AddLines	
Accessories_Canopy	Accessories_Canopy
Accessories_CanopyMaster	Accessories_CanopyMaster
Accessories_Cranes	Accessories_Cranes
Accessories_Cranes_Master	Accessories_Cranes_Master
Accessories_DBCIDoor	Accessories_DBCIDoor
Accessories_Facade	Accessories_Facade
Accessories_FramedOpening	Accessories_FramedOpening
Accessories_FramedOpening_Bkp_09_07	
Accessories_FramedOpening_Temp	
Accessories_Liner_Roof	
Accessories_Liner_Roof_Master	
Accessories_Liner_Wall	
Accessories_Liners	Accessories_Liners
Accessories_Liners_bkp_15_07	
Accessories_Liners_bkp_27_06	
Accessories_LouverSize	Accessories_LouverSize
Accessories_Louvers	Accessories_Louvers
Accessories_Parapet	Accessories_Parapet
Accessories_RubberPipeFlash	Accessories_RubberPipeFlash
Accessories_RubberPipeFlash_Size	Accessories_RubberPipeFlash_Size
Accessories_Valleygutters	Accessories_Valleygutters
Accessories_Vents	Accessories_Vents
Accessories_Vents_DropdownValue	Accessories_Vents_DropdownValue
Accessories_WalkDoors	Accessories_WalkDoors
Accessories_WalkDoors_bkp_15_07	
Accessories_WalkDoors_bkp_27_06	
Accessory	
AccessoryExclusionZone	AccessoryExclusionZone
AccessoryType	AccessoryType
Attachment	Attachment
BFM_Columns	BFM_Columns
BFM_FrameLines	BFM_FrameLines
BFM_Groups	BFM_Groups
BFM_InteriorColumnTypes	BFM_InteriorColumnTypes
BFM_Modules	BFM_Modules
Bookmarks	Bookmarks
Bracing	Bracing
Bracing_XBraceAnchor	Bracing_XBraceAnchor
BrandAssets	BrandAssets
BuilderAccessBrands	BuilderAccessBrands
BuilderAccessFieldMaster	BuilderAccessFieldMaster
BuilderAccessPermission	BuilderAccessPermission
BuilderAccessSection	BuilderAccessSection
BuilderAdministrator	BuilderAdministrator
BuilderAuthorizedSigner	BuilderAuthorizedSigner
BuilderInformation	BuilderInformation
BuilderInformation_11_04	
BuilderInformation_Main	
BuilderInformation_Old	
BuilderNews	BuilderNews
BuildingComplexityLeadDay	BuildingComplexityLeadDay
BuildingInformation	BuildingInformation
BuildingInformation_Temporary1	
BuildingInformation_Temporary2	
BuildingQuoteVariable	BuildingQuoteVariable
CAD_Express	CAD_Express
CAD_Options	CAD_Options
CAD_TitleBlock	CAD_TitleBlock
CLM_DesignCodes	CLM_DesignCodes
CLM_GeoRegions	CLM_GeoRegions
CLM_GoverningCodes	CLM_GoverningCodes
CLM_LoadTypes	CLM_LoadTypes
CLM_LoadValues	CLM_LoadValues
CLM_RiskCategory	CLM_RiskCategory
CLM_SiteClasses	
CLM_SnowExposures	CLM_SnowExposures
CLM_WindExposures	CLM_WindExposures
CL_BULIDING_LOAD_VALUE	CL_BULIDING_LOAD_VALUE
CL_ImportanceFactor	CL_ImportanceFactor
CL_Minimums	CL_Minimums
CL_MinimumsCanada	CL_MinimumsCanada
CL_Occupancy	CL_Occupancy
CL_Settings	CL_Settings
CL_SoilType	CL_SoilType
CL_StateAvailability	CL_StateAvailability
CL_StateAvailability_GovAg	CL_StateAvailability_GovAg
CL_ThermalFactor	CL_ThermalFactor
CUSTOMERLIST_FOR_EMP	
CUSTOMERTABLEFORCUSTOMERSYNC	
CartingType	
CategoryMargins	CategoryMargins
CoOpMarketing	
Collaterals	Collaterals
ColorCategory	ColorCategory
ColorCodes	ColorCodes
ColorMaster	ColorMaster
ColorMaster_587	ColorMaster_587
ColorPanel	ColorPanel
ColorPanel_587	ColorPanel_587
ColorPanel_8.15.0.6	ColorPanel_8.15.0.6
Company	Company
CompanyAlertMapping	CompanyAlertMapping
CompanyContactUsDetail	CompanyContactUsDetail
CompanyEmailNotification	CompanyEmailNotification
CompanyInformation	CompanyInformation
CompanyLabelMessagingDetail	CompanyLabelMessagingDetail
CompanyMailServerDetail	CompanyMailServerDetail
CompanyNotification	CompanyNotification
CompanyOrderDocumentationSetting	CompanyOrderDocumentationSetting
CompanyPermission	CompanyPortalDetail
CompanyPortalDetail	CoOpMarketing
Coordinates	CpuAddresses
Countries	CrmData
CpuAddresses	
CrmData	
CrmData_11_04	
Customer	Customer
CustomerArchiveFolders	CustomerArchiveFolders
CustomerReassignment	
Customer_Copy	
Customer_Main	
Customer_Temporary	
Customer_Test	
Customer_old	
DDP_A660	DDP_A660
DDP_BOOKMARK	DDP_BOOKMARK
DDP_BUILDINGLOADS	DDP_BUILDINGLOADS
DDP_CALCVERBLDGORDER	DDP_CALCVERBLDGORDER
DDP_COMPANY	DDP_COMPANY
DDP_CONTRACTENGINEERSADDRESSES	DDP_CONTRACTENGINEERSADDRESSES
DDP_CORNERSTONEUSERS	DDP_CORNERSTONEUSERS
DDP_CUSTOMREPORT	DDP_CUSTOMREPORT
DDP_CUSTOMREPORT_BKP	DDP_DEFAULTNOTEDRAWING
DDP_DEFAULTNOTEDRAWING	DDP_DEFAULTNOTESONDRAWINGCATEGORY
DDP_DEFAULTNOTESONDRAWINGCATEGORY	DDP_DEFAULTNOTESONDRAWINGSUBCATEGORY
DDP_DEFAULTNOTESONDRAWINGSUBCATEGORY	DDP_DESIGNPACKAGECHECKLIST
DDP_DESIGNPACKAGECHECKLIST	DDP_DESIGNPACKAGECHECKLISTDETAILS
DDP_DESIGNPACKAGECHECKLISTDETAILS	DDP_EDS_NOTESONDRAWING
DDP_EDSDB_BOXLAYGEOM	DDP_EDSDB_BOXLAYGEOM
DDP_EDSDB_BUILDING_VERSION	DDP_EDSDB_BUILDING_VERSION
DDP_EDSDB_GENINFO	DDP_EDSDB_GENINFO
DDP_EDSDB_SETTINGS	DDP_EDSDB_SETTINGS
DDP_EDSDB_VERSION	DDP_EDSDB_VERSION
DDP_EDS_NOTESONDRAWING	DDP_ENGINEERJUDGEMENT
DDP_ENGINEERJUDGEMENT	DDP_HISTORY
DDP_HISTORY	DDP_JOBPREFIXES
DDP_HISTORY_Bkp_16_02_2023	DDP_LOC_ENGINEERS
DDP_JOBPREFIXES	DDP_LOCTEMPLATES
DDP_LOCTEMPLATES	DDP_NOTESONDRAWING
DDP_LOC_ENGINEERS	DDP_REVISION_HISTORY
DDP_NOTESONDRAWING	DDP_TSSERVERS
DDP_NOTESONDRAWING_1_12_2022	DDP_USERCUSTOMNOTES
DDP_REVISION_HISTORY	DDP_VERSION_HISTORY
DDP_TSSERVERS	
DDP_USERCUSTOMNOTES	
DDP_VERSION_HISTORY	
DM_REGION	DM_REGION
DRAWINGMACHINES	
DRAWINGREQUEST	DRAWINGREQUEST
DRAWINGSTATUSMASTER	
DYNAMIC_TABINDEX	DYNAMIC_TABINDEX
DefaultScreenMaster	
Deflections	Deflections
DiaphragmActionExclusions	DiaphragmActionExclusions
DocumentPricing	DocumentPricing
DrawingType	DrawingType
Drawing_SubmittalPackage	Drawing_SubmittalPackage
Drawings	Drawings
ECS_EndwallFrameTypes	
EDSPRICE_I_PURCHASER	
EDSPrice_BuildingCodeMapping	EDSPrice_BuildingCodeMapping
EDSPrice_BuildingEndUseMapping	EDSPrice_BuildingEndUseMapping
EDSPrice_CAD_Advanced	EDSPrice_CAD_Advanced
EDSPrice_CAD_Express	EDSPrice_CAD_Express
EDSPrice_CAD_Landscape	EDSPrice_CAD_Landscape
EDSPrice_CAD_Options	EDSPrice_CAD_Options
EDSPrice_CAD_TitleBlock	EDSPrice_CAD_TitleBlock
EDSPrice_CS_LayerColor	EDSPrice_CodesLoads
EDSPrice_CS_Options	EDSPrice_CS_LayerColor
EDSPrice_CS_TitleBlock	EDSPrice_CS_Options
EDSPrice_CodesLoads	EDSPrice_CS_TitleBlock
EDSPrice_DifferentiatedPricingRxImpMultiplier	EDSPrice_DifferentiatedPricingRxImpMultiplier
EDSPrice_DifferentiatedPricingRxMultiplier	EDSPrice_DifferentiatedPricingRxMultiplier
EDSPrice_DifferentiatedPricingRxMultiplier_11_04	EDSPrice_DifferentiatedPricingRxRunSuccess
EDSPrice_DifferentiatedPricingRxRunSuccess	
EDSPrice_Flags	
EDSPrice_IO_ComplexityItems	EDSPrice_IO_ComplexityItems
EDSPrice_IO_Components	EDSPrice_IO_Components
EDSPrice_IO_Curbs	EDSPrice_IO_Curbs
EDSPrice_IO_Doors	EDSPrice_IO_Doors
EDSPrice_IO_Downspouts	EDSPrice_IO_Downspouts
EDSPrice_IO_ErectionData	EDSPrice_IO_ErectionData
EDSPrice_IO_ExteriorColumns	EDSPrice_IO_ExteriorColumns
EDSPrice_IO_GlassFront	EDSPrice_IO_GlassFront
EDSPrice_IO_Gutters	EDSPrice_IO_Gutters
EDSPrice_IO_MezzanineOpening	EDSPrice_IO_MezzanineOpening
EDSPrice_IO_MezzanineSpacing	EDSPrice_IO_Mezzanines
EDSPrice_IO_Mezzanines	EDSPrice_IO_MezzanineSpacing
EDSPrice_IO_SlideDoors	EDSPrice_IO_SlideDoors
EDSPrice_IO_SubmittalPackages	EDSPrice_IO_SubmittalPackages
EDSPrice_I_Components	EDSPrice_I_Components
EDSPrice_I_Cranes	EDSPrice_I_Cranes
EDSPrice_I_DrawingsCeco	EDSPrice_I_DrawingsCeco
EDSPrice_I_DrawingsStar	EDSPrice_I_DrawingsStar
EDSPrice_I_EWPlaza	EDSPrice_I_ErectionInformation
EDSPrice_I_ErectionInformation	EDSPrice_I_EWPlaza
EDSPrice_I_ICElevations	EDSPrice_I_ICElevations
EDSPrice_I_NetAddLineDetails	EDSPrice_I_NetAddLineDetails
EDSPrice_I_Order	EDSPrice_I_Order
EDSPrice_I_OrderRequests	EDSPrice_I_OrderRequests
EDSPrice_I_Owner	EDSPrice_I_Owner
EDSPrice_I_PartitionsSpecifiedGirts	EDSPrice_I_PartitionsSpecifiedGirts
EDSPrice_I_Payment	EDSPrice_I_Payment
EDSPrice_I_ProjectInformation	EDSPrice_I_ProjectInformation
EDSPrice_I_Shipping	
EDSPrice_I_Taxes	EDSPrice_I_Taxes
EDSPrice_O_AnchorBolts	EDSPrice_O_AnchorBolts
EDSPrice_O_AnchorBolts_History	
EDSPrice_O_BuildingTotal	EDSPrice_O_BuildingTotal
EDSPrice_O_Buyouts	EDSPrice_O_Buyouts
EDSPrice_O_CanopyPurlins	EDSPrice_O_CanopyPurlins
EDSPrice_O_CanopyPurlins_BKP	
EDSPrice_O_CanopyRafters	EDSPrice_O_CanopyRafters
EDSPrice_O_CanopyRafters_BKP	
EDSPrice_O_Deflections	EDSPrice_O_Deflections
EDSPrice_O_DesignData	EDSPrice_O_DesignData
EDSPrice_O_DesignData_History	
EDSPrice_O_EWColumns	EDSPrice_O_EWColumns
EDSPrice_O_EWIndividualLoads	EDSPrice_O_EWIndividualLoads
EDSPrice_O_EWIndividualLoads_History	
EDSPrice_O_EWPlates	EDSPrice_O_EWPlates
EDSPrice_O_EWRafters	EDSPrice_O_EWRafters
EDSPrice_O_ErectionData	EDSPrice_O_ErectionData
EDSPrice_O_ErrorReports	EDSPrice_O_ErrorReports
EDSPrice_O_Errors	EDSPrice_O_Errors
EDSPrice_O_FBrace	EDSPrice_O_FBrace
EDSPrice_O_FBrace_History	
EDSPrice_O_FLBoss	EDSPrice_O_FLBoss
EDSPrice_O_FLJoints	EDSPrice_O_FLJoints
EDSPrice_O_FLJoints_History	
EDSPrice_O_FLPlates	EDSPrice_O_FLPlates
EDSPrice_O_FLPlates_History	
EDSPrice_O_FLSegments	EDSPrice_O_FLSegments
EDSPrice_O_FLSegments_History	
EDSPrice_O_FLStiffeners	EDSPrice_O_FLStiffeners
EDSPrice_O_Girts	EDSPrice_O_Girts
EDSPrice_O_Girts_History	
EDSPrice_O_IndividualLoads	EDSPrice_O_IndividualLoads
EDSPrice_O_IndividualLoads_History	
EDSPrice_O_InteriorColumns	EDSPrice_O_InteriorColumns
EDSPrice_O_OpenAreas	EDSPrice_O_OpenAreas
EDSPrice_O_PortalFrames	EDSPrice_O_PortalFrames
EDSPrice_O_Pricing	EDSPrice_O_Pricing
EDSPrice_O_ProjectTotal	EDSPrice_O_ProjectTotal
EDSPrice_O_Purlins	EDSPrice_O_Purlins
EDSPrice_O_Purlins_History	
EDSPrice_O_RMGData	EDSPrice_O_RMGData
EDSPrice_O_RMGData_1.6.0	EDSPrice_O_RMGData_1.6.0
EDSPrice_O_Reports	EDSPrice_O_Reports
EDSPrice_O_SagBracing	EDSPrice_O_SagBracing
EDSPrice_O_SupportBeams	EDSPrice_O_SupportBeams
EDSPrice_O_XBracing	EDSPrice_O_XBracing
EDSPrice_O_XBracing_History	
EDSPrice_PEF_Values	EDSPrice_PEF_Values
EDSPrice_Panel_Mapping	EDSPrice_Panel_Mapping
EDSPrice_PriceStatus	EDSPrice_PriceStatus
EDSPrice_PricingResults	EDSPrice_PricingResults
EDSPrice_ProcessingResults	EDSPrice_ProcessingResults
EDSPrice_Program_Version_All	EDSPrice_Program_Version_All
EDSPrice_Testing	
EmailQueue	EmailQueue
EndWallPotalFrame	EndWallPotalFrame
Escarpment	Escarpment
ExportToOE	ExportToOE
ExportToOEServiceCenter	ExportToOEServiceCenter
Exported_Users	
FeaturedAnnouncements	FeaturedAnnouncements
GeoRegions	GeoRegions
GeometryInformation	GeometryInformation
GirtsAndPurlinDepth	GirtsAndPurlinDepth
GirtsAndPurlinStyle	GirtsAndPurlinStyle
Groups	Groups
Groups_Users	
HistoryEvents	HistoryEvents
Hybris_Customer_User	
Hybris_Customer_User_Temp	
Hybris_Temp	
Hybris_Temp_withHybrisID	
I_Address	I_Address
ImagePurpose	
Imp_Vendor	Imp_Vendor
InformationPageAdministrations	InformationPageAdministrations
Input_AddLines	Input_AddLines
Input_Bays	Input_Bays
Input_Endwall	Input_Endwall
Input_Endwalls_ColumnSpacing	Input_Endwalls_ColumnSpacing
Input_Endwalls_OpenArea	
Input_Endwalls_Recesses	Input_Endwalls_Recesses
Input_GirtsBaySpacing	Input_GirtsBaySpacing
Input_GirtsBaySpacing_Girt	Input_GirtsBaySpacing_Girt
Input_GirtsBaySpacing_GirtSpecified	Input_GirtsBaySpacing_GirtSpecified
Input_GirtsBaySpacing_Purlin	Input_GirtsBaySpacing_Purlin
Input_GirtsBaySpacing_Wall	Input_GirtsBaySpacing_Wall
Input_NetAddLineDetails	Input_NetAddLineDetails
Input_Owner	Input_Owner
Input_Roof	Input_Roof
Input_RoofCommonData	
Input_RoofMaster	Input_RoofMaster
Input_RoofMaster_Old	
Input_RoofMaster_Test	
Input_ShopCoat	Input_ShopCoat
Input_Trim	Input_Trim
Input_TrimColorSelections	Input_TrimColorSelections
Input_TrimColorSelections_bkp_10_07	
Input_Wall	Input_Wall
Insulation	Insulation
InsulationAccessories	InsulationAccessories
InsulationAccessoriesMaster	InsulationAccessoriesMaster
InsulationAccessoriesMaster_Import	InsulationAccessoriesMaster_Import
InsulationMaster	InsulationMaster
Jobs	Jobs
LMSAccess	LMSAccess
Log_Deleted_Poject_By_Scheduler	Log_Deleted_Poject_By_Scheduler
Log_Table	
MBSBuildingPrice	
MY_TEMP_TABLE	
M_CS_LayerColor	M_CS_LayerColor
M_CS_TitleBlock	M_CS_TitleBlock
M_DownspoutType	M_DownspoutType
M_EDSPrice_ABS_Accessories_1.6.0	M_EDSPrice_ABS_Accessories_1.6.0
M_EDSPrice_ABS_Accessories_1.6.4	M_EDSPrice_ABS_Accessories_1.6.4
M_EDSPrice_ABS_Accessories_1.6.6	M_EDSPrice_ABS_Accessories_1.6.6
M_EDSPrice_ABS_InsulationAccessories_1.4.3	M_EDSPrice_ABS_Insulation_1.6.31
M_EDSPrice_ABS_InsulationAccessories_8.15.0.10	M_EDSPrice_ABS_Insulation_8.15.0.10
M_EDSPrice_ABS_Insulation_1.4.3	M_EDSPrice_ABS_InsulationAccessories_8.15.0.10
M_EDSPrice_ABS_Insulation_1.6.31	M_EDSPrice_ABS_MiscPricing_1.6.0
M_EDSPrice_ABS_Insulation_8.15.0.10	M_EDSPrice_ABS_MiscPricing_1.6.3
M_EDSPrice_ABS_MiscPricing_1.6.0	M_EDSPrice_ABS_MiscPricing_1.6.31
M_EDSPrice_ABS_MiscPricing_1.6.3	M_EDSPrice_ABS_MiscPricing_1.6.6
M_EDSPrice_ABS_MiscPricing_1.6.31	M_EDSPrice_Corporate_Accessory_Pricing_8.15.0.6
M_EDSPrice_ABS_MiscPricing_1.6.6	M_EDSPrice_Counties_Canada_8.15.0.6
M_EDSPrice_Corporate_Accessory_Pricing_8.15.0.6	M_EDSPrice_Counties_States_8.15.0.6
M_EDSPrice_Counties_Canada_8.15.0.6	M_EDSPrice_County_Cities_8.15.0.6
M_EDSPrice_Counties_States_8.15.0.6	M_EDSPrice_Door_Pricing_8.15.0.9
M_EDSPrice_County_Cities_8.15.0.6	M_EDSPrice_Hours_8.15.0.6
M_EDSPrice_Door_Pricing_8.15.0.9	M_EDSPrice_ICFreight_1.6.0
M_EDSPrice_Hours_8.15.0.6	M_EDSPrice_ICFreight_1.6.31
M_EDSPrice_ICFreight_1.6.0	M_EDSPrice_IMP_Adds_1.6.0
M_EDSPrice_ICFreight_1.6.31	M_EDSPrice_IMP_Adds_1.6.31
M_EDSPrice_IMPColorCategories_8.15.0.6	M_EDSPrice_IMP_Adds_2A34
M_EDSPrice_IMPSetupCharges_1.6.31	M_EDSPrice_IMP_FreightRates_1.6.0
M_EDSPrice_IMPSetupCharges_2A34	M_EDSPrice_IMP_FreightRates_2A34
M_EDSPrice_IMPSetupCharges_8.15.0.6	M_EDSPrice_IMP_Multipliers_8.15.0.6
M_EDSPrice_IMPShortOrderCharges_8.15.0.6	M_EDSPrice_IMP_MultipliersArch_1.6.0
M_EDSPrice_IMP_Adds_1.6.0	M_EDSPrice_IMP_MultipliersArch_1.6.31
M_EDSPrice_IMP_Adds_1.6.31	M_EDSPrice_IMP_MultipliersArch_2A34
M_EDSPrice_IMP_Adds_2A34	M_EDSPrice_IMP_MultipliersArchXfer_1.6.0
M_EDSPrice_IMP_FreightRates_1.6.0	M_EDSPrice_IMP_MultipliersArchXfer_1.6.31
M_EDSPrice_IMP_FreightRates_2A34	M_EDSPrice_IMP_MultipliersRoof_1.6.0
M_EDSPrice_IMP_MultipliersArchXfer_1.6.0	M_EDSPrice_IMP_MultipliersRoof_1.6.31
M_EDSPrice_IMP_MultipliersArchXfer_1.6.31	M_EDSPrice_IMP_MultipliersRoof_2A34
M_EDSPrice_IMP_MultipliersArch_1.6.0	M_EDSPrice_IMP_MultipliersRoofXfer_1.6.0
M_EDSPrice_IMP_MultipliersArch_1.6.31	M_EDSPrice_IMP_MultipliersRoofXfer_1.6.31
M_EDSPrice_IMP_MultipliersArch_2A34	M_EDSPrice_IMP_MultipliersTexture_1.6.0
M_EDSPrice_IMP_MultipliersRoofXfer_1.6.0	M_EDSPrice_IMP_MultipliersTexture_1.6.31
M_EDSPrice_IMP_MultipliersRoofXfer_1.6.31	M_EDSPrice_IMP_MultipliersTexture_2A34
M_EDSPrice_IMP_MultipliersRoof_1.6.0	M_EDSPrice_IMP_MultipliersTextureXfer_1.6.0
M_EDSPrice_IMP_MultipliersRoof_1.6.31	M_EDSPrice_IMP_MultipliersTextureXfer_1.6.31
M_EDSPrice_IMP_MultipliersRoof_2A34	M_EDSPrice_IMP_MultipliersThermalSafe_1.6.0
M_EDSPrice_IMP_MultipliersTextureXfer_1.6.0	M_EDSPrice_IMP_MultipliersThermalSafe_1.6.31
M_EDSPrice_IMP_MultipliersTextureXfer_1.6.31	M_EDSPrice_IMP_MultipliersThermalSafe_2A34
M_EDSPrice_IMP_MultipliersTexture_1.6.0	M_EDSPrice_IMP_MultipliersThermalSafeXfer_1.6.0
M_EDSPrice_IMP_MultipliersTexture_1.6.31	M_EDSPrice_IMP_MultipliersThermalSafeXfer_1.6.31
M_EDSPrice_IMP_MultipliersTexture_2A34	M_EDSPrice_IMP_MultipliersTraditional_1.6.0
M_EDSPrice_IMP_MultipliersThermalSafeXfer_1.6.0	M_EDSPrice_IMP_MultipliersTraditional_1.6.31
M_EDSPrice_IMP_MultipliersThermalSafeXfer_1.6.31	M_EDSPrice_IMP_MultipliersTraditional_2A34
M_EDSPrice_IMP_MultipliersThermalSafe_1.6.0	M_EDSPrice_IMP_MultipliersTraditionalXfer_1.6.0
M_EDSPrice_IMP_MultipliersThermalSafe_1.6.31	M_EDSPrice_IMP_MultipliersTraditionalXfer_1.6.31
M_EDSPrice_IMP_MultipliersThermalSafe_2A34	M_EDSPrice_IMP_PanelsPerTruckIndex_8.15.0.6
M_EDSPrice_IMP_MultipliersTraditionalXfer_1.6.0	M_EDSPrice_IMP_PanelsPerTruckWidth_8.15.0.6
M_EDSPrice_IMP_MultipliersTraditionalXfer_1.6.31	M_EDSPrice_IMPColorCategories_8.15.0.6
M_EDSPrice_IMP_MultipliersTraditional_1.6.0	M_EDSPrice_IMPSetupCharges_1.6.31
M_EDSPrice_IMP_MultipliersTraditional_1.6.31	M_EDSPrice_IMPSetupCharges_2A34
M_EDSPrice_IMP_MultipliersTraditional_2A34	M_EDSPrice_IMPSetupCharges_8.15.0.6
M_EDSPrice_IMP_Multipliers_8.15.0.6	M_EDSPrice_IMPShortOrderCharges_8.15.0.6
M_EDSPrice_IMP_PanelsPerTruckIndex_8.15.0.6	M_EDSPrice_MBMA_Complexity_8.15.0.6
M_EDSPrice_IMP_PanelsPerTruckWidth_8.15.0.6	M_EDSPrice_MMA_Complexity_8.15.0.6
M_EDSPrice_MBMA_Complexity_8.15.0.6	M_EDSPrice_Program_Accessories_8.15.0.6
M_EDSPrice_MMA_Complexity_8.15.0.6	M_EDSPrice_Program_BoilerPlateNotes
M_EDSPrice_Program_Accessories_8.15.0.6	M_EDSPrice_Program_BoilerPlateNotes_8.15.0.6
M_EDSPrice_Program_BoilerPlateNotes	M_EDSPrice_Program_Crane_8.15.0.6
M_EDSPrice_Program_BoilerPlateNotes_8.15.0.6	M_EDSPrice_Program_DBCIAccessories_1.6.0
M_EDSPrice_Program_Crane_8.15.0.6	M_EDSPrice_Program_DBCIDoors_1.6.0
M_EDSPrice_Program_DBCIAccessories_1.6.0	M_EDSPrice_Program_DMs_8.15.0.6
M_EDSPrice_Program_DBCIDoors_1.6.0	M_EDSPrice_Program_Erection_8.15.0.6
M_EDSPrice_Program_DMs_8.15.0.6	M_EDSPrice_Program_Flatliner_8.15.0.6
M_EDSPrice_Program_Erection_8.15.0.6	M_EDSPrice_Program_FlatlinerMarkup_8.15.0.6
M_EDSPrice_Program_FlatlinerMarkup_8.15.0.6	M_EDSPrice_Program_IPS_FreightByCounty_8.15.0.6
M_EDSPrice_Program_Flatliner_8.15.0.6	M_EDSPrice_Program_IPS_Loads_8.15.0.6
M_EDSPrice_Program_IPS_FreightByCounty_8.15.0.6	M_EDSPrice_Program_IPS_Plants_2A34
M_EDSPrice_Program_IPS_Loads_8.15.0.6	M_EDSPrice_Program_IPS_Plants_8.15.0.6
M_EDSPrice_Program_IPS_Plants_2A34	M_EDSPrice_Program_MBCI_Markup_8.15.0.6
M_EDSPrice_Program_IPS_Plants_8.15.0.6	M_EDSPrice_Program_Multiplier_Info_8.15.0.6
M_EDSPrice_Program_MBCI_Markup_8.15.0.6	M_EDSPrice_Program_Panels_8.15.0.6
M_EDSPrice_Program_Multiplier_Info_8.15.0.6	M_EDSPrice_Program_PrivateLabel_8.15.0.6
M_EDSPrice_Program_Panels_8.15.0.6	M_EDSPrice_Program_ProcessingCharges_8.15.0.6
M_EDSPrice_Program_PrivateLabel_8.15.0.6	M_EDSPrice_Program_RTS_1.6.6
M_EDSPrice_Program_ProcessingCharges_8.15.0.6	M_EDSPrice_Program_RTS_8.15.0.6
M_EDSPrice_Program_RTS_1.6.6	M_EDSPrice_Program_ShipBy_8.15.0.6
M_EDSPrice_Program_RTS_8.15.0.6	M_EDSPrice_Program_SuggestedBays_8.15.0.6
M_EDSPrice_Program_ShipBy_8.15.0.6	M_EDSPrice_Program_SupportBeams_1.4.0
M_EDSPrice_Program_SuggestedBays_8.15.0.6	M_EDSPrice_Program_Surcharges_1.4.6
M_EDSPrice_Program_SupportBeams_1.4.0	M_EDSPrice_RMG_Adjustments_1.5.5
M_EDSPrice_Program_Surcharges_1.4.6	M_EDSPrice_RMG_Adjustments_1.6.0
M_EDSPrice_RMG_Adjustments_1.5.5	M_EDSPrice_RMG_Adjustments_1.6.31
M_EDSPrice_RMG_Adjustments_1.6.0	M_EDSPrice_ShippingPoints_8.15.0.6
M_EDSPrice_RMG_Adjustments_1.6.31	
M_EDSPrice_RMG_Adjustments_1.6.6	
M_EDSPrice_ShippingPoints_8.15.0.6	
M_Facade_Type	M_Facade_Type
M_NetAddlineHeader	M_NetAddlineHeader
M_PanelType	M_PanelType
M_PanelType_New	
M_PanelType_Old	
M_Panel_Dropdown	M_Panel_Dropdown
M_Panel_Dropdown_New_New	
M_Panel_Dropdown_Old	
M_QQ_EaveHeight	
M_QQ_EndwallBayConfiguration	
M_QQ_EndwallBayConfigurationChoice	
M_QQ_EndwallWidth	
M_QQ_PanelTypeThicknessChoice	
M_QQ_RoofSlope	
M_QQ_SidewallBayConfiguration	
M_QQ_SidewallBayConfigurationChoice	
M_QQ_SidewallLength	
M_QQ_TableOfTable	
Maintenance	Maintenance
Mapping	Mapping
Mapping_Agora	Mapping_Agora
MarketingAdmin	MarketingAdmin
MenuAdmin	MenuAdmin
MenuGroupNode	
MenuPage	
MenuStaticNode	
Notification	Notification
Notifications_Templates	Notifications_Templates
OE3_Categories	OE_Categories
OE_Categories	OE3_Categories
ONC	
Occupancies	
OpenAreas	OpenAreas
OpenAreas_Master	OpenAreas_Master
OpenAreas_bkp_15_07	
OpenAreas_bkp_27_06	
OrderChanges	
OrderContactUsersLog	OrderContactUsersLog
OrderContactUsersQueue	OrderContactUsersQueue
OutputDocument_Mapping	OutputDocument_Mapping
PROGRAM_ERRORS_EXPEDITED_ANCHORROD	
PROGRAM_ERRORS_EXPEDITED_ANCHORROD_TRANSACTION	
PROJECT_08_07_2024	
PROJECT_BKP_09_04	
PROJECT_DATA_BK_09_04	
Permission	Permission
PermissionBrand	PermissionBrand
PermissionGroup	PermissionGroup
PermissionGroupFeaturesMatrix	PermissionGroupFeaturesMatrix
PermissionItems	PermissionItems
PermissionRoles	PermissionRoles
PermissionTransaction	PermissionTransaction
Photos	Photos
PointLoads	PointLoads
PolicyStatement	PolicyStatement
PortalFeatures	
PresidentsAdvisoryCouncil	PresidentsAdvisoryCouncil
PriceAlerts	PriceAlerts
PriceLogs	PriceLogs
PricingSegmentValues	PricingSegmentValues
PricingSegments	PricingSegments
PricingSummaries	PricingSummaries
Program_Errors	Program_Errors
Program_Errors_8.15.0.6	Program_Errors_8.15.0.6
Program_SuggestedBays	Program_SuggestedBays
Project	Project
ProjectNotes	ProjectNotes
ProjectUser	ProjectUser
ProjectUser_Restore	
Project_Bkp	
Project_Bkp_02_04	
Project_Bkp_11_04	
Project_Estimating	Project_Estimating
Project_Hours	Project_Hours
Project_Restore	
Purchaser	Purchaser
Purchaser_11_04	
Purchaser_Bkp	
Release_Notes	Release_Notes
Report_CustomerPermission	Report_CustomerPermission
Report_CustomerPermission_11_04	
Report_Log	
Report_ResetMaster	Report_ResetMaster
RoleMaster	RoleMaster
SBSAdmin	SBSAdmin
SEAMERRENTAL_ROOFPANEL	SEAMERRENTAL_ROOFPANEL
SEAMERRENTAL_SEAMINGTOOL	SEAMERRENTAL_SEAMINGTOOL
SEAMERRENTAL_STATE	SEAMERRENTAL_STATE
ShipByComponents	ShipByComponents
ShipPlantCountriesToShip	ShipPlantCountriesToShip
ShipPlantLeadDays	ShipPlantLeadDays
Shipping	Shipping
ShippingGroup	ShippingGroup
ShippingPlantGrouping	ShippingPlantGrouping
ShippingPlants	ShippingPlants
ShippingPlantsTemp	ShippingPlantsTemp
ShippingZone	ShippingZone
SideWallPortalFrame	SideWallPortalFrame
Skinning	Skinning
SkinningTypographyDetail	SkinningTypographyDetail
SkinningTypographyHeader	SkinningTypographyHeader
SubCompanyInformation	SubCompanyInformation
SupportBeams	SupportBeams
SupportingDocuments	SupportingDocuments
SystemVariable	SystemVariable
TEMP_CUSTOMER_23_07	
TEMP_VALUES	
TableOfTables	TableOfTables
TempForOrderManagement_ArchiveOrders_CustNumber	TempForOrderManagement_ArchiveOrders_CustNumber
TempForOrderManagement_Test_CustNumber	TempForOrderManagement_Test_CustNumber
Temp_Insert_08_07	
Temp_Project_Ids_Insert_08_07	
Temp_Test_Customer	Temp_Test_Customer
TermsAndCondition	TermsAndCondition
TermsConditions	TermsConditions
Test_Table	
Tools_ProjectNotes	Tools_ProjectNotes
USR_BRAND_CUSTOMER_12_12_2022	
USR_BRAND_CUSTOMER_Temp	
USR_Brand_Customer	USR_Brand_Customer
USR_Brand_Customer_09092024	
USR_Brand_Customer_Removed	USR_Brand_Customer_Removed
USR_Brand_Customer_old	
USR_Brand_Mapping	USR_Brand_Mapping
USR_Brand_PermissionGroup	USR_Brand_PermissionGroup
USR_Favorite	USR_Favorite
USR_Favorite_Restore	
USR_PER_BuilderAccess	USR_PER_BuilderAccess
USR_UserDetail	USR_UserDetail
USR_UserDetailAdditional	USR_UserDetailAdditional
USR_UserDetailAdditional_FROM_UAT_12_07	
USR_UserDetail_Bkp	
USR_UserDetail_Bkp_02_04	
USR_UserDetail_Bkp_11_04	
USR_UserDetail_FROM_UAT_12_07	
UnitOfMeasure	
UpcomingEvent_Timezones	UpcomingEvent_Timezones
UpcomingEventsAdministration	UpcomingEventsAdministration
UserAlertSubscription	UserAlertSubscription
UserAlertSubscription_Restore	
WEBLINKSMASTER	
WO_BOM_COMPARE_REPORT	WO_BOM_COMPARE_REPORT
customerlist_for_Heritage	
	PROGRAM_ERRORS_EXPEDITED_ANCHORROD
	PROGRAM_ERRORS_EXPEDITED_ANCHORROD_TRANSACTION
	R12_CUSTOMERRIDDIDBSR_MTV
	R12_CUSTOMERRIDDIDBSR_MTV_STG
	MBSBuildingPrice
	MY_TEMP_TABLE
	Company_Temp
	Customer_Temporary
	CUSTOMERLIST_FOR_EMP
	customerlist_for_Heritage
	CUSTOMERTABLEFORCUSTOMERSYNC
